111111111111111111111111111111111111111111111111111111111
111111100000000000000000000000000000000000000000001111111
111111100000000000000000000000C000000000000000000011P1111
111111100000000000000000000000000000000000000000001101111
100000000000000000000000000000000000000000000000000000001
100000000000000C00000000000000000000000000000000000000001
100000000000000000000000011111100000000000000000000000001
100000000C00000000000000011111100000000000000000000000001
100000000000000000000000011111100000000000000000000000001
100000000000000000000000011111100000000000000000000000001
10000000000000000000C000000000000000000000000000000000001
100000000000000000000000000000000000000000000000000000001
1001111111111000000000000000000000000C0000000000000000001
100100000000100000000000000000000000000000000000000000001
1001011111101000000000000C0000000000000000000000000000001
1001011E11101000000000000000000000000000000000000C0000001
100101101110100000000000000000000000000000000000000000001
100101100000100000000000000000000000000000000000000000001
100001111111100000000000000000000000000000000000000000001
111111111111111111111111111111111111111111111111111111111