1111111111111
1C000010100C1
1000000100000
1P0000E000001
1111111111111