1111111111111
1C000010100C1
1000000100011
1P000000001E1
1111111111111