1111111111111
1C000010100C1
1000000100001
1P000E0000001
1111111111111