111111111111111111111111111
1E0C10000000000000000000011
11010000000000000e000000111
100000000000000000000P00001
111111111111111111111111111